GAME
{
// PDA belongs to Brad Campbell

// Inbox

"MailFrom1"	"Từ: David Anders"
"MailDate1"	"Ngày: 12/12/52"
"MailSubject1"	"Chủ đề: Bộ đồ bảo hộ"
"MailBody1A"	"Ôi trời ơi Brad, sức nóng đang trở nên không thể chịu nổi được. Chúng tôi lại tìm thêm một trường dung nham ở gần đường hầm số 11, cho nên mọi việc sẽ khó có thể được cải thiện. Thế còn mấy bộ đồ bảo hộ đó thì sao?"
"MailBody1B"	"Dave"

"MailFrom2"	"Từ: David Anders"
"MailDate2"	"Ngày: 14/12/52"
"MailSubject2"	"Chủ đề: Daxol"
"MailBody2A"	"Brad,"
"MailBody2B"	"Mẹ kiếp. Tôi đã nói chuyện với Pete và Kovac. Họ công khai thừa nhận là mọi người đã bắt đầu sử dụng lại Daxol một cách thường xuyên. Ngay khi lúc chúng tôi nghĩ mọi thứ đang trở lại bình thường. Giờ ông muốn tôi phải làm gì?"

// Sent

"MailFrom3"	"Tới: David Anders"
"MailDate3"	"Ngày: 12/12/52"
"MailSubject3"	"Chủ đề: Re: Bộ đồ bảo hộ"
"MailBody3A"	"Chào Dave,"
"MailBody3B"	"Tôi đã đặt hàng chúng từ lâu rồi. Không hiểu tại sao chúng không có ở trong hàng tiếp tế con thoi mới đây. Tất cả mà tôi có thể làm là phàn nàn, điều mà tôi đang làm, nhưng ông biết điều đó làm được gì tốt đến mức nào. Nhân tiện, tôi đã nghe các tin đồn về việc lạm dụng Daxol đang gia tăng trở lại. Ông có thể để mắt tới được không?"
"MailBody3C"	"Trân trọng, Brad"

"MailFrom4"	"Tới: David Anders"
"MailDate4"	"Ngày: 14/12/52"
"MailSubject4"	"Chủ đề: Re: Daxol"
"MailBody4A"	"David,"
"MailBody4B"	"Cảm ơn nhé. Tôi sẽ trò chuyện với họ. Tôi không muốn báo cáo điều này. Tôi đã luôn luôn nói là các công nhân phải được trả công mỗi giờ, chứ không phải theo việc họ có thể đào các hố trên tảng đá chết tiệt đó nhanh đến mức nào. Không có gì nhiều mà chúng tôi có thể làm được về nó."
}